2,3,1,1,1,1,1,1,1,10
2,3,1,1,1,1,1,1,1,1
2,3,1,1,1,1,1,1,1,1
2,3,1,1,1,1,1,1,1,1
2,3,1,1,1,1,1,1,1,1
2,3,1,1,5,1,1,1,1,1
2,3,1,1,1,1,1,1,1,1
2,3,1,1,1,1,1,1,1,1
2,3,1,1,1,1,1,1,1,1
2,3,1,1,1,1,1,1,1,6

