0,0,0,0,0,0,1,1,1,1,1,0,0,0,0
0,0,0,0,0,0,1,1,10,1,1,0,0,0,0
0,0,0,0,0,0,1,1,1,1,1,0,0,0,0
0,0,0,0,0,0,0,0,3,0,0,0,0,0,0
0,0,0,0,0,0,0,0,3,0,0,0,0,0,0
0,0,0,0,0,0,0,0,3,0,0,0,0,0,0
0,0,0,0,0,0,0,0,3,0,0,0,0,0,0
0,0,0,2,2,2,2,2,3,0,0,0,0,0,0
0,0,0,2,0,0,0,0,0,0,0,0,0,0,0
0,0,0,2,0,0,0,0,0,0,0,0,0,0,0
0,0,1,8,1,0,0,0,0,0,0,0,0,0,0
0,0,1,1,1,0,2,2,6,0,0,0,0,0,0
0,0,7,1,1,0,0,0,0,0,0,0,0,0,0
0,0,0,3,0,0,0,0,0,0,0,0,0,0,0
0,0,0,3,0,0,0,0,0,0,0,0,0,0,0
0,0,0,3,0,0,0,0,0,0,0,0,0,0,0
0,0,0,3,3,3,3,3,3,3,1,1,8,1,1
0,0,0,3,3,3,3,3,3,3,1,1,1,1,1
0,0,0,0,0,0,0,0,0,0,1,1,1,1,1
0,0,0,0,0,0,0,0,0,0,0,0,2,2,0
0,0,0,0,0,0,0,0,0,0,0,0,2,2,0
0,0,0,0,0,0,0,2,2,2,2,2,2,2,0
0,0,0,0,0,0,0,2,2,2,2,2,2,2,0
0,0,0,0,0,0,0,2,2,0,0,0,0,0,0
0,0,0,0,0,0,0,2,2,0,0,0,0,0,0
0,0,0,0,0,0,0,2,2,0,0,0,0,0,0
0,0,0,1,1,1,1,1,1,8,1,1,0,0,0
0,0,0,1,1,1,1,5,1,1,1,1,0,0,0
0,0,0,1,1,1,1,1,1,1,1,1,0,0,0
0,0,0,1,1,1,1,1,1,1,1,1,0,0,0

