0,0,0,0,0,0,0,0,0,0,0,0,0,0
0,0,0,0,0,0,0,0,0,0,1,1,1,1
0,0,0,0,0,0,0,0,0,0,1,1,10,1
0,0,0,0,0,0,0,0,0,0,1,1,1,1
0,0,0,0,0,2,4,4,4,4,4,0,0,0
0,0,0,2,2,2,0,0,0,0,0,0,0,0
0,0,0,3,0,0,0,0,0,0,0,0,0,0
0,0,0,3,0,0,0,0,0,0,0,0,0,0
0,0,0,3,0,0,0,0,0,0,0,0,0,0
0,0,0,3,0,0,8,1,0,2,2,0,0,0
4,4,4,4,4,4,1,1,0,0,0,0,0,0
0,0,0,0,0,0,0,0,0,0,0,0,3,3
0,0,0,0,0,0,0,0,0,0,0,0,3,3
0,0,0,0,0,0,0,0,0,0,0,0,0,0
0,0,0,0,0,0,0,0,0,0,0,0,0,0
0,0,4,3,3,0,0,0,2,8,0,0,4,4
0,0,4,0,0,0,0,2,2,2,0,0,4,4
0,0,4,0,0,0,0,0,0,0,0,0,0,0
0,0,8,0,0,0,0,0,0,0,0,0,0,0
3,3,3,0,0,0,0,0,0,0,0,0,0,0
3,0,0,0,0,0,0,0,0,0,0,0,0,0
0,0,0,0,0,0,0,0,0,0,0,0,0,0
4,4,4,0,0,0,0,0,0,0,0,0,0,0
0,0,4,0,0,0,0,0,0,0,0,0,0,0
0,0,0,0,0,0,0,0,0,0,0,0,0,0
8,7,0,0,0,0,4,4,0,0,0,0,0,0
0,2,0,0,0,0,0,0,0,0,0,0,0,0
0,2,2,2,2,0,0,0,0,6,0,0,0,0
0,0,0,0,2,0,0,0,0,0,0,0,0,0
0,0,0,0,0,0,0,0,0,0,0,0,0,0
0,0,0,0,0,0,0,0,0,0,0,0,0,0
8,1,3,3,3,0,0,0,0,0,0,0,0,0
1,1,0,0,0,0,0,0,0,0,0,0,0,0
4,0,0,0,0,0,0,0,0,0,0,0,0,0
4,0,0,0,0,0,0,0,0,0,0,0,0,0
4,4,4,4,0,0,0,0,0,0,0,0,0,0
0,0,0,4,0,0,0,0,0,0,0,0,0,0
0,0,0,4,4,4,1,1,1,1,0,0,0,0
0,0,0,0,0,0,1,1,1,1,0,0,0,0
0,0,0,0,0,0,8,1,5,1,0,0,0,0

