0,0,0,0,0,0,0,0,0,0,0,1,10,1,0
0,0,0,0,0,0,0,0,0,0,0,1,1,1,0
0,0,0,0,0,0,0,0,0,0,0,0,0,0,0
0,0,0,0,0,0,0,0,0,2,0,0,0,0,0
0,0,0,0,0,0,0,0,0,2,0,0,0,0,0
0,0,0,0,0,0,0,0,0,0,0,0,0,0,0
0,0,0,0,0,0,0,0,0,0,0,0,0,0,0
2,2,2,2,2,8,0,0,3,3,0,0,0,0,0
2,0,0,0,0,0,0,0,0,0,0,0,0,0,0
2,0,0,0,0,0,0,0,0,0,0,0,0,0,0
2,0,0,0,0,0,0,0,0,0,0,0,0,0,3
2,0,0,0,0,0,0,0,0,0,0,0,0,0,3
2,3,0,0,0,0,0,0,0,0,0,0,0,0,0
0,3,0,0,0,0,0,0,0,0,0,0,0,0,3
0,3,0,0,3,3,3,3,0,0,2,0,0,0,3
0,3,0,0,3,0,0,0,0,0,2,0,0,0,0
0,3,0,0,3,0,0,0,0,0,2,0,0,0,0
0,8,3,3,3,0,0,0,0,0,2,0,0,0,0
0,0,0,0,0,0,0,0,0,1,8,1,0,0,0
0,0,0,0,0,0,0,0,0,1,1,1,0,0,0
0,0,0,0,0,0,0,0,0,0,2,0,0,0,0
0,0,0,0,0,0,0,0,0,0,2,0,0,0,0
0,0,0,0,0,0,0,0,0,0,2,0,0,0,0
0,0,0,0,0,0,0,0,0,0,2,0,0,0,0
0,0,0,0,0,0,3,3,2,2,2,0,0,0,0
0,0,0,0,0,0,3,0,0,0,0,0,0,0,0
0,0,0,0,0,0,3,0,0,0,0,0,0,0,0
1,1,1,1,3,3,3,0,0,0,0,0,0,0,0
8,1,5,1,3,3,3,0,0,0,0,0,0,0,0
1,1,1,1,0,0,0,0,0,0,0,0,0,0,0
